4,4,4,4,6,4,4,4,4,4
0,0,0,0,0,0,0,0,0,0
0,5,0,0,0,0,0,5,0,0
0,0,0,0,0,0,0,0,0,0
0,0,0,0,3,0,0,0,0,3
0,3,3,3,3,0,0,0,3,3
0,3,0,0,0,0,0,3,3,3
2,3,2,0,0,0,2,3,3,3