4,4,1,4,4
0,0,0,0,0
0,5,0,0,0
3,0,0,0,0
3,3,2,0,3
